############
#        O #
#  X       #
#    P     #
############